Abdominal fibromatosis	Abdominal (Mesenteric) Fibromatosis
Acantholytic squamous cell carcinoma	Skin Acantholytic Squamous Cell Carcinoma
Acinar adenocarcinoma	Acinar Cell Carcinoma
Acinar cell carcinoma	Acinar Cell Carcinoma
Acinar cell tumor	Acinar Cell Neoplasm
Acral lentiginous melanoma, malignant	Acral Lentiginous Melanoma
Acute erythroid leukaemia	Acute Erythroid Leukemia
Acute leukemia, NOS	Acute Leukemia
Acute lymphoblastic leukemia NOS	Acute Lymphoblastic Leukemia
Acute lymphoblastic leukemia precursor cell type	Acute Lymphoblastic Leukemia
Acute megakaryoblastic leukaemia	Acute Megakaryoblastic Leukemia
Acute monoblastic and monocytic leukemia	Acute Monoblastic and Monocytic Leukemia
Acute monocytic leukemia	Acute Monocytic Leukemia
Acute myeloid leukaemia, t(8;21)(q22;q22)	Acute Myeloid Leukemia with t(8;21); (q22; q22.1); RUNX1-RUNX1T1
Acute myeloid leukemia MLL	Acute Myeloid Leukemia with KMT2A Rearrangement
Acute myeloid leukemia with abnormal marrow eosinophils (includes all variants)	Acute Myeloid Leukemia with inv(16)(p13.1q22) or t(16;16)(p13.1;q22); CBFB-MYH11
Acute myeloid leukemia with inv(3)(q21q26.2) or t(3;3)(q21;q26.2); RPN1-EVI1	Acute Myeloid Leukemia with inv(3) (q21.3;q26.2) or t(3;3) (q21.3;q26.2); GATA2, MECOM
Acute myeloid leukemia with maturation	Acute Myeloid Leukemia with Maturation
Acute myeloid leukemia with multilineage dysplasia	Acute Myeloid Leukemia with Multilineage Dysplasia
Acute myeloid leukemia with mutated CEBPA	Acute Myeloid Leukemia with CEBPA Mutation
Acute myeloid leukemia with mutated NPM1	Acute Myeloid Leukemia with NPM1 Mutation
Acute myeloid leukemia with myelodysplasia-related changes	Acute Myeloid Leukemia with Myelodysplasia-Related Changes
Acute myeloid leukemia with t(6;9)(p23;q34); DEK-NUP214	Acute Myeloid Leukemia with t(6;9) (p22.3;q34.1); DEK-NUP214
Acute myeloid leukemia with t(8;21)(q22;q22); RUNX1-RUNX1T1	Acute Myeloid Leukemia with t(8;21); (q22; q22.1); RUNX1-RUNX1T1
Acute myeloid leukemia with t(9;11)(p22;q23); MLLT3-MLL	Acute Myeloid Leukemia with t(9;11)(p21.3;q23.3); MLLT3- KMT2A
Acute myeloid leukemia without maturation	Acute Myeloid Leukemia without Maturation
Acute myeloid leukemia, CBF-beta/MYH11	Acute Myeloid Leukemia with inv(16)(p13.1q22) or t(16;16)(p13.1;q22); CBFB-MYH11
Acute myeloid leukemia, M6 type	Acute Erythroid Leukemia
Acute myeloid leukemia, NOS	Acute Myeloid Leukemia Not Otherwise Specified
Acute myeloid leukemia, inv(16)(p13;q22)	Acute Myeloid Leukemia with inv(16)(p13.1q22) or t(16;16)(p13.1;q22); CBFB-MYH11
Acute myeloid leukemia, minimal differentiation	Acute Myeloid Leukemia with Minimal Differentiation
Acute myelomonocytic leukemia	Acute Myelomonocytic Leukemia
Acute myloid leukemia, 11q23 abnormalities	Acute Myeloid Leukemia with KMT2A Rearrangement
Acute promyelocytic leukaemia, PML-RAR-alpha	Acute Promyelocytic Leukemia with t(15;17)(q24.1;q21.2); PML-RARA
Acute promyelocytic leukaemia, t(15;17)(q22;q11-12)	Acute Promyelocytic Leukemia with t(15;17)(q24.1;q21.2); PML-RARA
Adamantinomatous craniopharyngioma	Adamantinomatous Craniopharyngioma
Adenocarcinoma	Adenocarcinoma
Adenocarcinoma NOS	Adenocarcinoma
Adenocarcinoma combined with other types of carcinoma	Lung Adenocarcinoma, Mixed Subtype
Adenocarcinoma in situ, NOS	Adenocarcinoma In Situ
Adenocarcinoma in tubolovillous adenoma	Adenocarcinoma in Tubulovillous Adenoma
Adenocarcinoma intestinal type	Intestinal-Type Adenocarcinoma
Adenocarcinoma metastatic NOS	Metastatic Adenocarcinoma
Adenocarcinoma of anal glands	Anal Glands Adenocarcinoma
Adenocarcinoma with mixed subtypes	Lung Adenocarcinoma, Mixed Subtype
Adenocarcinoma with neuroendocrine differentiation	Adenocarcinoma with Neuroendocrine Differentiation
Adenocarcinoma, NOS	Adenocarcinoma
Adenocarcinoma, diffuse type	Diffuse Type Adenocarcinoma
Adenocarcinoma, endocervical type	Endocervical Adenocarcinoma, Usual-Type
Adenocarcinoma, intestinal type	Intestinal-Type Adenocarcinoma
Adenocarcinoma, metastatic, NOS	Metastatic Adenocarcinoma
Adenoid cystic carcinoma	Adenoid Cystic Carcinoma
Adenomyoepithelioma	Breast Adenomyoepithelioma
Adenosarcoma	Adenosarcoma
Adenosquamous	Adenosquamous Carcinoma
Adenosquamous carcinoma	Adenosquamous Carcinoma
Adnexal carcinoma	Adnexal Carcinoma
Adrenal cortical adenoma, NOS	Adrenal Cortical Adenoma
Adrenal cortical carcinoma	Adrenal Cortical Carcinoma
Adrenocortical carcinoma- Usual Type	Adrenal Cortical Low Grade Carcinoma
Adult T-cell leukemia/lymphoma (HTLV-1 positive) (includes all variants)	Adult T-Cell Leukemia/Lymphoma
Aggressive fibromatosis	Desmoid Fibromatosis
Alveolar Rhabdomyosarcoma	Alveolar Rhabdomyosarcoma
Alveolar rhabdomyosarcoma	Alveolar Rhabdomyosarcoma
Alveolar soft part sarcoma	Alveolar Soft Part Sarcoma
Amelanotic melanoma	Amelanotic Melanoma
Anaplastic ependymoma	Anaplastic Ependymoma
Angiocentric Glioma	Angiocentric Glioma
Angiocentric glioma	Angiocentric Glioma
Angioimmunoblastic T-cell lymphoma	Angioimmunoblastic T-Cell Lymphoma
Angiomyolipoma	Angiomyolipoma
Angiosarcoma	Angiosarcoma
Apocrine adenocarcinoma	Apocrine Carcinoma
Astroblastoma	Astroblastoma, MN1-Altered
Astrocytic Glioma	Astrocytoma
Astrocytic neoplasm	Astrocytic Tumor
Astrocytoma	Astrocytoma
Astrocytoma, NOS	Astrocytoma
Astrocytoma, anaplastic	Anaplastic Astrocytoma
Atypical Teratoid/Rhabdoid Tumor	Atypical Teratoid/Rhabdoid Tumor
Atypical adenoma	Atypical Adenoma
Atypical carcinoid tumor	Atypical Carcinoid Tumor
Atypical choroid plexus papilloma	Atypical Choroid Plexus Papilloma
Atypical chronic myeloid leukemia, BCR/ABL negative	Atypical Chronic Myeloid Leukemia
Atypical meningioma	Atypical Meningioma
Atypical teratoid/rhabdoid tumor	Atypical Teratoid/Rhabdoid Tumor
B lymphoblastic leukemia/lymphoma with hyperdiploidy	Hyperdiploid B Lymphoblastic Leukemia/Lymphoma
B lymphoblastic leukemia/lymphoma with t(1;19)(q23;p13.3); E2A-PBX1 (TCF3-PBX1)	B Lymphoblastic Leukemia/Lymphoma with t(1;19)(q23;p13.3); TCF3-PBX1
B lymphoblastic leukemia/lymphoma with t(9;22)(q34;q11.2); BCR-ABL1	B Lymphoblastic Leukemia/Lymphoma with t(9;22)(q34.1;q11.2); BCR-ABL1
B lymphoblastic leukemia/lymphoma with t(v;11q23); MLL rearranged	B Lymphoblastic Leukemia/Lymphoma with t(v;11q23.3); KMT2A Rearranged
B lymphoblastic leukemia/lymphoma, NOS	B Lymphoblastic Leukemia/Lymphoma, Not Otherwise Specified
B-cell lymphocytic leukemia/small lymphocytic lymphoma	Chronic Lymphocytic Leukemia/Small Lymphocytic Lymphoma
Basal cell carcinoma, NOS	Basal Cell Carcinoma
Basaloid carcinoma	Basaloid Carcinoma
Basaloid squamous cell carcinoma	Basaloid Squamous Cell Carcinoma
Biphasic Synovial Sarcoma	Biphasic Synovial Sarcoma
Blastic plasmacytoid dendritic cell neoplasm	Blastic Plasmacytoid Dendritic Cell Neoplasm
Brain Tumor	Brain Neoplasm
Brain tumor, Medulloblastoma	Medulloblastoma
Brain tumor, low grade glioma	Low Grade Glioma
Brain tumor, pilocytic astrocytoma	Pilocytic Astrocytoma
Brenner tumor, NOS	Brenner Tumor
Bronchio-alveolar carcinoma, mucinous	Invasive Lung Mucinous Adenocarcinoma
Bronchiolo-alveolar adenocarcinoma, NOS	Lepidic Adenocarcinoma
Bronchiolo-alveolar carcinoma, NOS	Lepidic Adenocarcinoma
Bronchiolo-alveolar carcinoma, non-mucinous	Minimally Invasive Lung Non-Mucinous Adenocarcinoma
Burkitt-like lymphoma	Atypical Burkitt/Burkitt-Like Lymphoma
CNS Embryonal Tumor	Central Nervous System Embryonal Tumor
Carcinoma NOS	Carcinoma
Carcinoma, NOS	Carcinoma
Carcinoma, anaplastic, NOS	Undifferentiated Carcinoma
Carcinoma, diffuse type	Diffuse Type Adenocarcinoma
Carcinoma, undifferentiated, NOS	Undifferentiated Carcinoma
Carcinosarcoma NOS	Carcinosarcoma
Carcinosarcoma, NOS	Carcinosarcoma
Cellular ependymoma	Cellular Ependymoma
Cellular spindle cell neoplasm	Spindle Cell Neoplasm
Central Neurocytoma	Central Neurocytoma
Central neuroblastoma	Central Nervous System Neuroblastoma
Central neurocytoma	Central Neurocytoma
Cerebellopontine angle tumor	Cerebellopontine Angle Neoplasm
Cervical Squamous Cell Carcinoma	Cervical Squamous Cell Carcinoma
Cholangiocarcinoma	Cholangiocarcinoma
Cholangiocarcinoma; distal	Cholangiocarcinoma
Cholangiocarcinoma; hilar/perihilar	Cholangiocarcinoma
Cholangiocarcinoma; intrahepatic	Intrahepatic Cholangiocarcinoma
Chondroblastic osteosarcoma	Chondroblastic Osteosarcoma
Chondroblastoma, NOS	Chondroblastoma
Chondrosarcoma, NOS	Chondrosarcoma
Chordoma, NOS	Chordoma
Choriocarcinoma, NOS	Choriocarcinoma
Choroid plexus carcinoma	Choroid Plexus Carcinoma
Choroid plexus neoplasm	Choroid Plexus Neoplasm
Choroid plexus papillary tumor	Choroid Plexus Papilloma
Choroid plexus papilloma	Choroid Plexus Papilloma
Choroid plexus papilloma, NOS	Choroid Plexus Papilloma
Chromophobe RCC	Chromophobe Renal Cell Carcinoma
Chronic eosinophilic leukemia, NOS	Chronic Eosinophilic Leukemia, Not Otherwise Specified
Chronic myeloid leukemia, NOS	Chronic Myeloid Leukemia, BCR-ABL1 Positive
Chronic myelomonocytic leukemia, NOS	Chronic Myelomonocytic Leukemia
Chronic neutrophilic leukemia	Chronic Neutrophilic Leukemia
Classical/Usual (Papillary NOS)	Papillary Carcinoma
Clear cell RCC	Clear Cell Renal Cell Carcinoma
Clear cell adenocarcinoma, NOS	Clear Cell Adenocarcinoma
Clear cell carcinoma	Clear Cell Adenocarcinoma
Clear cell odontogenic carcinoma	Clear Cell Odontogenic Carcinoma
Clear cell sarcoma of kidney	Clear Cell Sarcoma of the Kidney
Clear cell sarcoma, NOS	Clear Cell Sarcoma of Soft Tissue
Collecting duct carcinoma	Collecting Duct Carcinoma
Colon Adenocarcinoma	Colon Adenocarcinoma
Colon Mucinous Adenocarcinoma	Colon Mucinous Adenocarcinoma
Combined hepatocellular carcinoma and cholangiocarcinoma	Combined Hepatocellular Carcinoma and Cholangiocarcinoma
Combined small cell-squamous cell carcinoma	Combined Lung Small Cell Carcinoma
Craniopharyngioma	Craniopharyngioma
Craniopharyngioma, adamantinomatous	Adamantinomatous Craniopharyngioma
Craniopharyngioma, papillary	Papillary Craniopharyngioma
Cribriform carcinoma, NOS	Cribriform Carcinoma
Cystadenocarcinoma, NOS	Cystadenocarcinoma
Dedifferentiated chondrosarcoma	Dedifferentiated Chondrosarcoma
Dedifferentiated liposarcoma	Dedifferentiated Liposarcoma
Dermatofibroma, NOS	Skin Fibrous Histiocytoma
Dermatofibrosarcoma protuberans	Dermatofibrosarcoma Protuberans
Dermatofibrosarcoma, NOS	Fibrosarcomatous Dermatofibrosarcoma Protuberans
Desmoid Tumor	Desmoid Fibromatosis
Desmoid-Type Fibromatosis	Desmoid Fibromatosis
Desmoplastic melanoma, malignant	Desmoplastic Melanoma
Desmoplastic nodular medulloblastoma	Desmoplastic Nodular Medulloblastoma
Desmoplastic small round cell tumor	Desmoplastic Small Round Cell Tumor
Diffuse astrocytoma	Diffuse Astrocytoma
Diffuse hemispheric high-grade glioma	Diffuse Hemispheric Glioma, H3 G34-Mutant
Diffuse malignant mesothelioma - Biphasic	Biphasic Mesothelioma
Diffuse malignant mesothelioma - Epithelioid	Epithelioid Mesothelioma
Diffuse midline glioma	Diffuse Midline Glioma
Diffuse midline glioma H3K27M	Diffuse Midline Glioma, H3 K27M-Mutant
Diffused astrocytoma	Diffuse Astrocytoma
Duct adenocarcinoma, NOS	Breast Ductal Carcinoma
Duct carcinoma, NOS	Breast Ductal Carcinoma
Ductal carcinoma NOS	Breast Ductal Carcinoma In Situ
Ductal carcinoma in situ NOS	Breast Ductal Carcinoma In Situ
Ductal carcinoma in situ, NOS	Breast Ductal Carcinoma In Situ
Ductal carcinoma, NOS	Breast Ductal Carcinoma In Situ
Dysembroplastic neuroepithelial tumor	Mouse Dysembryoplastic Neuroepithelial Tumour
Dysembryoplastic Neuroepithelial Tumor	Dysembryoplastic Neuroepithelial Tumor
Dysembryoplastic neuroepithelial tumor	Dysembryoplastic Neuroepithelial Tumor
Dysgerminoma	Ovarian Dysgerminoma
EBV positive diffuse large B-cell lymphoma of the elderly	EBV-Positive Diffuse Large B-Cell Lymphoma, Not Otherwise Specified
Eccrine poroma, malignant	Porocarcinoma
Eccrine spiradenoma	Spiradenoma
Embryonal Rhabdomyosarcoma	Embryonal Rhabdomyosarcoma
Embryonal carcinoma, NOS	Embryonal Carcinoma
Embryonal rhabdomyosarcoma	Embryonal Rhabdomyosarcoma
Embryonal rhabdomyosarcoma, NOS	Embryonal Rhabdomyosarcoma
Embryonal sarcoma	Liver Embryonal Sarcoma
Embryonal tumor	Embryonal Neoplasm
Embryonal tumor with multilayered rosettes	Embryonal Tumor with Multilayered Rosettes
Endocervical Adenocarcinoma of the Usual Type	Endocervical Carcinoma
Endocervical Type of Adenocarcinoma	Endocervical Adenocarcinoma, Usual-Type
Endometrial stromal sarcoma, NOS	Endometrioid Stromal Sarcoma
Endometrial stromal sarcoma, low grade	Uterine Corpus Low Grade Endometrial Stromal Sarcoma
Endometrioid adenocarcinoma, NOS	Endometrioid Adenocarcinoma
Endometrioid adenocarcinoma, secretory variant	Endometrial Endometrioid Adenocarcinoma, Secretory Variant
Endometrioid adenoma, borderline malignancy	Borderline Ovarian Endometrioid Adenofibroma
Endometrioid endometrial adenocarcinoma	Endometrioid Adenocarcinoma
Ependymoma	Ependymoma
Ependymoma NOS	Ependymoma
Ependymoma with Anaplasia	Anaplastic Ependymoma
Ependymoma, NOS	Ependymoma
Ependymoma, anaplastic	Anaplastic Ependymoma
Epithelial-myoepithelial carcinoma	Epithelial-Myoepithelial Carcinoma
Epithelioid Cell	Epithelioid Cell Nevus
Epithelioid cell melanoma	Epithelioid Cell Melanoma
Epithelioid hemangioendothelioma, malignant	Epithelioid Hemangioendothelioma
Epithelioid leiomyosarcoma	Epithelioid Leiomyosarcoma
Epithelioid mesothelioma, malignant	Intraductal Papilloma
Epithelioid sarcoma	Epithelioid Sarcoma
Epitheloid sarcoma	Epithelioid Sarcoma
Essential thrombocythemia	Essential Thrombocythemia
Esthesioneuroblastoma	Olfactory Neuroblastoma
Ewing sarcoma	Ewing Sarcoma
Extra-adrenal paraganglioma, NOS	Extra-Adrenal Paraganglioma
Extra-adrenal paraganglioma, malignant	Extra-Adrenal Paraganglioma
Familial adenomatous polyposis	Familial Adenomatous Polyposis
Fibroblastic osteosarcoma	Fibroblastic Osteosarcoma
Fibrolamellar hepatocellular carcinoma	Fibrolamellar Carcinoma
Fibromatosis	Fibromatosis
Fibromyxosarcoma	Myxofibrosarcoma
Fibrosarcoma, NOS	Fibrosarcoma
Fibrous mesothelioma, malignant	Sarcomatoid Mesothelioma
Follicular adenocarcinoma, NOS	Thyroid Gland Follicular Carcinoma
Follicular adenocarcinoma, well differentiated	Thyroid Gland Follicular Carcinoma
Follicular carcinoma, NOS	Thyroid Gland Follicular Carcinoma
Follicular carcinoma, minimally invasive	Thyroid Gland Follicular Carcinoma, Minimally Invasive
Follicular dendritic cell sarcoma	Follicular Dendritic Cell Sarcoma
Follicular lymphoma, NOS	Follicular Lymphoma
Ganglioglioma	Ganglioglioma
Ganglioglioma, NOS	Ganglioglioma
Ganglioglioma, anaplastic	Anaplastic Ganglioglioma
Ganglioneuroblastoma	Ganglioneuroblastoma
Ganglioneuroma	Ganglioneuroma
Gastrointestinal stromal tumor, NOS	Gastrointestinal Stromal Tumor
Gastrointestinal stromal tumor, malignant	Malignant Gastrointestinal Stromal Tumor
Germ cell tumor, NOS	Germ Cell Tumor
Germ cell tumor, nonseminomatous	Nongerminomatous Germ Cell Tumor
Germinoma	Germinoma
Giant cell carcinoma	Giant Cell Carcinoma
Giant cell sarcoma	Giant Cell Sarcoma
Giant cell tumor of bone, NOS	Giant Cell Tumor of Bone
Giant pigmented nevus, NOS	Giant Congenital Nevus
Glassy cell carcinoma	Glassy Cell Carcinoma
Glial Neoplasm	Glioma
Glial tumor	Glioma
Glial/glioneuronal neoplasm	Glioma
Glioblastoma	Glioblastoma
Glioblastoma Multiforme (GBM)	Glioblastoma
Glioblastoma multiforme	Glioblastoma
Gliolblastoma	Glioblastoma
Glioma	Glioma
Glioma malignant	Malignant Glioma
Glioma, NOS	Glioma
Glioma, malignant	Malignant Glioma
Gliosarcoma	Gliosarcoma
Glomangiosarcoma	Malignant Glomus Tumor
Granular cell tumor, NOS	Granular Cell Tumor
Granulosa cell tumor, NOS	Adult Granulosa Cell Tumor
Granulosa cell tumor, adult type	Adult Ovarian Granulosa Cell Tumor
Haemangioblastoma	Hemangioblastoma
Haemangiosarcoma	Angiosarcoma
Hairy cell leukemia	Hairy Cell Leukemia
Head & Neck Squamous Cell Carcinoma	Head and Neck Squamous Cell Carcinoma
Hemangioblastoma	Hemangioblastoma
Hemangioma, NOS	Hemangioma
Hemangiopericytoma, NOS	Hemangiopericytoma
Hepatoblastoma	Hepatoblastoma
Hepatocellular Carcinoma	Hepatocellular Carcinoma
Hepatocellular carcinoma, NOS	Hepatocellular Carcinoma
Hepatocellular carcinoma, clear cell type	Clear Cell Hepatocellular Carcinoma
Hepatocellular carcinoma, fibrolamellar	Fibrolamellar Carcinoma
Hepatocellular carcinoma, spindle cell variant	Sarcomatoid Hepatocellular Carcinoma
Hepatocholangiocarcinoma (Mixed)	Combined Hepatocellular Carcinoma and Cholangiocarcinoma
Hepatoid adenocarcinoma	Hepatoid Adenocarcinoma
High Grade astrocytoma	Anaplastic Astrocytoma
High grade glioma	Malignant Glioma
High grade surface osteosarcoma	High Grade Surface Osteosarcoma
High-grade glial neoplasm	Malignant Glioma
High-grade glioma	Malignant Glioma
High-grade malignant neoplasm	High Grade Malignant Neoplasm
High-grade serous carcinoma	High Grade Surface Osteosarcoma
Histiocytic malignancy	Malignant Histiocytosis
Hodgkin lymphoma, NOS	Hodgkin Lymphoma
Hodgkin lymphoma, nodular lymphocyte predominance	Nodular Lymphocyte Predominant Hodgkin Lymphoma
Hurthle cell tumor	Thyroid Gland Oncocytic Neoplasm
Hyalinizing trabecular adenoma	Thyroid Gland Hyalinizing Trabecular Tumor
Hydatidiform mole, NOS	Hydatidiform Mole
Indolent systemic mastocytosis	Indolent Systemic Mastocytosis
Infant hemispheric glioma	Infant-Type Hemispheric Glioma
Infiltrating Ductal Carcinoma	Invasive Breast Carcinoma of No Special Type
Infiltrating Lobular Carcinoma	Invasive Breast Lobular Carcinoma
Infiltrating duct and lobular carcinoma	Invasive Breast Ductal Carcinoma and Lobular Carcinoma
Infiltrating duct and mucinous carcinoma	Invasive Breast Ductal Carcinoma and Lobular Carcinoma
Infiltrating duct carcinoma NOS	Invasive Breast Carcinoma of No Special Type
Infiltrating duct carcinoma, NOS	Invasive Breast Carcinoma of No Special Type
Infiltrating duct mixed with other types of carcinoma	Invasive Breast Ductal Carcinoma and Lobular Carcinoma
Infiltrating ductular carcinoma	Invasive Breast Carcinoma of No Special Type
Infiltrating lobular carcinoma, NOS	Invasive Breast Lobular Carcinoma
Infiltrating lobular mixed with other types of carcinoma	Breast Ductal Carcinoma In Situ and Invasive Lobular Carcinoma
Inflammatory carcinoma	Breast Inflammatory Carcinoma
Insular carcinoma	Poorly Differentiated Thyroid Gland Carcinoma
Interdigitating dendritic cell sarcoma	Interdigitating Dendritic Cell Sarcoma
Intimal sarcoma	Intimal Sarcoma
Intraductal carcinoma, noninfiltrating, NOS	Breast Ductal Carcinoma In Situ
Intraductal micropapillary carcinoma	Breast Micropapillary Ductal Carcinoma In Situ
Intraductal papillary adenocarcinoma with invasion	Breast Papillary Ductal Carcinoma In Situ with Invasion
Intraductal papillary carcinoma	Breast Papillary Ductal Carcinoma In Situ
Intraductal papillary-mucinous carcinoma, invasive	Pancreatic Intraductal Papillary-Mucinous Neoplasm with an Associated Invasive Carcinoma
Intraosseous well differentiated osteosarcoma	Low Grade Central Osteosarcoma
Intravascular large B-cell lymphoma	Intravascular Large B-Cell Lymphoma
Intraventricular tumor	Intraventricular Brain Neoplasm
Invasive lobular carcinoma	Invasive Breast Lobular Carcinoma
Invasive mammary carcinoma	Invasive Breast Carcinoma
Invasive mucinous adenocarcinoma	Invasive Lung Mucinous Adenocarcinoma
Juvenile myelomonocytic leukemia	Juvenile Myelomonocytic Leukemia
Kidney Chromophobe	Chromophobe Renal Cell Carcinoma
Kidney Clear Cell Renal Carcinoma	Clear Cell Renal Cell Carcinoma
Kidney Papillary Renal Cell Carcinoma	Papillary Renal Cell Carcinoma
Kupffer cell sarcoma	Liver Angiosarcoma
Large cell medulloblastoma	Large Cell Medulloblastoma
Large cell neuroendocrine carcinoma	Large Cell Neuroendocrine Carcinoma
Left Temporal Tumor	Temporal Lobe Neoplasm
Leiomyoma, NOS	Leiomyoma
Leiomyosarcoma (LMS)	Leiomyosarcoma
Leiomyosarcoma, NOS	Leiomyosarcoma
Lentigo maligna melanoma	Lentigo Maligna Melanoma
Lepidic adenocarcinoma	Lepidic Adenocarcinoma
Leukemia, NOS	Leukemia
Lipid cell tumor of ovary	Ovarian Steroid Cell Tumor
Liposarcoma, NOS	Liposarcoma
Liposarcoma, well differentiated	Atypical Lipomatous Tumor/Well Differentiated Liposarcoma
Lobular adenocarcinoma	Breast Lobular Carcinoma
Lobular and ductal carcinoma	Breast Mixed Ductal and Lobular Carcinoma
Lobular carcinoma NOS	Breast Lobular Carcinoma
Lobular carcinoma in situ, NOS	Breast Lobular Carcinoma In Situ
Lobular carcinoma, NOS	Breast Lobular Carcinoma
Low grade astrocytoma	Low Grade Astrocytoma
Low grade glial neoplasm	Low Grade Glioma
Low grade glial tumor	Low Grade Glioma
Low grade glioma	Low Grade Glioma
Low-grade Glioma	Low Grade Glioma
Low-grade astrocytoma	Low Grade Astrocytoma
Low-grade glioma	Low Grade Glioma
Low-grade glioma consistent with pilocytic astrocytoma	Pilocytic Astrocytoma
Low-grade glioma-pilocytic astrocytoma	Pilocytic Astrocytoma
Lung Basaloid Squamous Cell Carcinoma	Lung Basaloid Squamous Cell Carcinoma
Lung Papillary Squamous Cell Caricnoma	Lung Squamous Cell Carcinoma, Papillary Variant
Lung Small Cell Squamous Cell Carcinoma	Lung Squamous Cell Carcinoma, Small Cell Variant
Lymphangiomyomatosis	Lymphangioleiomyomatosis
Lymphoepithelial carcinoma	Nasopharyngeal-Type Undifferentiated Carcinoma
Malignant Pecoma	Malignant PEComa
Malignant Peripheral Nerve Sheath Tumors (MPNST)	Malignant Peripheral Nerve Sheath Tumor
Malignant fibrous histiocytoma	Undifferentiated Pleomorphic Sarcoma
Malignant histiocytosis	Malignant Histiocytosis
Malignant lymphoma, NOS	Lymphoma
Malignant lymphoma, large B-cell, diffuse, NOS	Diffuse Large B-Cell Lymphoma
Malignant mastocytosis	Malignant Mastocytosis
Malignant melanoma, NOS	Melanoma
Malignant myoepithelioma	Malignant Myoepithelioma
Malignant peripheral nerve sheath tumor	Malignant Peripheral Nerve Sheath Tumor
Malignant rhabdoid	Rhabdoid Tumor
Malignant rhabdoid tumor	Rhabdoid Tumor
Malignant tumor, small cell type	Malignant Tumor, Small Cell Type
Mantle cell lymphoma (Includes all variants blastic, pleomorphic, small cell)	Mantle Cell Lymphoma
Marginal zone B-cell lymphoma, NOS	Marginal Zone Lymphoma
Mediastinal (thymic) large B-cell lymphoma	Primary Mediastinal (Thymic) Large B-Cell Lymphoma
Medullary Carcinoma	Medullary Carcinoma, Not Otherwise Specified
Medullary carcinoma NOS	Medullary Carcinoma, Not Otherwise Specified
Medullary carcinoma, NOS	Medullary Carcinoma, Not Otherwise Specified
Medulloblastoma	Medulloblastoma
Medulloblastoma, NOS	Medulloblastoma, Not Otherwise Specified
Melanoma	Melanoma
Meningioma	Meningioma
Meningioma, NOS	Meningioma
Meningioma, malignant	Anaplastic (Malignant) Meningioma
Merkel cell carcinoma	Merkel Cell Carcinoma
Mesenchymal chondrosarcoma	Mesenchymal Chondrosarcoma
Mesenchymoma, NOS	Mesenchymoma
Mesodermal mixed tumor	Mixed Mesodermal (Mullerian) Tumor
Mesonephroma, malignant	Mesonephric Adenocarcinoma
Mesothelioma, biphasic, malignant	Biphasic Mesothelioma
Mesothelioma, malignant	Malignant Mesothelioma
Metaplastic Carcinoma	Metaplastic Carcinoma
Metaplastic carcinoma, NOS	Metaplastic Carcinoma
Mixed epithelioid and spindle cell melanoma	Mixed Epithelioid and Spindle Cell Melanoma
Mixed germ cell tumor	Mixed Germ Cell Tumor
Mixed glioma	Mixed Glioma
Mixed phenotype acute leukemia with t(9;22)(q34;q11.2); BCR-ABL1	Mixed Phenotype Acute Leukemia with t(9;22)(q34.1;q11.2); BCR-ABL1
Mixed phenotype acute leukemia with t(v;11q23); MLL rearranged	Mixed Phenotype Acute Leukemia with t(v;11q23.3); KMT2A Rearranged
Mixed phenotype acute leukemia, B/myeloid, NOS	Mixed Phenotype Acute Leukemia, B/Myeloid, Not Otherwise Specified
Mixed phenotype acute leukemia, T/myeloid, NOS	Mixed Phenotype Acute Leukemia, T/Myeloid, Not Otherwise Specified
Mixed type rhabdomyosarcoma	Rhabdomyosarcoma with Mixed Embryonal and Alveolar Features
Mucinous (Colloid) Carcinoma	Mucinous Adenocarcinoma
Mucinous Adenocarcinoma of Endocervical Type	Endocervical Adenocarcinoma, Usual-Type
Mucinous Carcinoma	Mucinous Adenocarcinoma
Mucinous adenocarcinoma	Mucinous Adenocarcinoma
Mucinous adenocarcinoma, endocervical type	Endocervical Adenocarcinoma, Usual-Type
Mucinous carcinoma	Mucinous Adenocarcinoma
Mucinous cystadenoma, NOS	Mucinous Cystadenoma
Mucinous cystic tumor of borderline malignancy	Lung Colloid Adenocarcinoma
Mucoepidermoid carcinoma	Mucoepidermoid Carcinoma
Mucosal lentiginous melanoma	Mucosal Lentiginous Melanoma
Mucous adenocarcinoma	Mucinous Adenocarcinoma
Mullerian mixed tumor	Mixed Mesodermal (Mullerian) Tumor
Multiple myeloma	Multiple Myeloma
Mycosis fungoides	Mycosis Fungoides
Myelodysplastic syndrome with 5q deletion (5q-) syndrome	Myelodysplastic Syndrome with del(5q)
Myelodysplastic syndrome with isolated del (5q)	Myelodysplastic Syndrome with del(5q)
Myelodysplastic syndrome, NOS	Myelodysplastic Syndrome
Myelodysplastic syndrome, unclassifiable	Myelodysplastic Syndrome, Unclassifiable
Myelodysplastic/myeloproliferative neoplasm, unclassifiable	Myelodysplastic/Myeloproliferative Neoplasm, Not Otherwise Specified
Myeloid and lymphoid neoplasms with PDGFRA rearrangement	Myeloid/Lymphoid Neoplasms with PDGFRA Rearrangement
Myeloid leukemia associated with Down Syndrome	Myeloid Leukemia Associated with Down Syndrome
Myeloid sarcoma	Myeloid Sarcoma
Myeloproliferative neoplasm, NOS	Myeloproliferative Neoplasm
Myloproliferative neoplasm, unclassifiable	Myeloproliferative Neoplasm, Unclassifiable
Myoepithelial carcinoma	Malignant Myoepithelioma
Myofibroblastic tumor, NOS	Inflammatory Myofibroblastic Tumor
Myofibroblastic tumor, peribronchial	Lung Inflammatory Myofibroblastic Tumor
Myofibroma	Myofibroma
Myxofibrosarcoma	Myxofibrosarcoma
Myxoid chondrosarcoma	Myxoid Chondrosarcoma
Myxoid leiomyosarcoma	Myxoid Leiomyosarcoma
Myxoid liposarcoma	Myxoid Liposarcoma
Myxoma, NOS	Myxoma
Myxopapillary Ependymoma	Myxopapillary Ependymoma
Myxopapillary ependymoma	Myxopapillary Ependymoma
Myxosarcoma	Myxosarcoma
Nasopharyngeal carcinoma metastatic	Metastatic Nasopharyngeal Carcinoma
Neoplasm	Neoplasm
Neoplasm, benign	Benign Neoplasm
Neoplasm, malignant	Malignant Neoplasm
Neoplasm, uncertain whether benign or malignant	Neoplasm, Uncertain Whether Benign or Malignant
Nephroblastoma, NOS	Kidney Wilms Tumor
Neurilemoma, NOS	Schwannoma
Neurinomatosis	Schwannomatosis
Neuroblastoma NOS	Neuroblastoma
Neuroblastoma, NOS	Neuroblastoma
Neuroendocrine carcinoma, NOS	Neuroendocrine Carcinoma
Neuroepithelial neoplasm	Neuroepithelial Neoplasm
Neuroepithelial neoplasm, Glioma	Glioma
Neurofibroma, NOS	Neurofibroma
Neurofibromatosis; Moderately cellular neoplasm	Neurofibromatosis
Nodular melanoma	Cutaneous Nodular Melanoma
Non-Seminoma; Choriocarcinoma	Testicular Choriocarcinoma
Non-Seminoma; Embryonal Carcinoma	Testicular Embryonal Carcinoma
Non-Seminoma; Teratoma (Immature)	Testicular Immature Teratoma
Non-Seminoma; Teratoma (Mature)	Testicular Mature Teratoma
Non-Seminoma; Yolk Sac Tumor	Testicular Yolk Sac Tumor
Non-WNT/non-SHH medulloblastoma	Medulloblastoma, Non-WNT/Non-SHH
Non-small cell carcinoma	Non-Small Cell Carcinoma
Nonencapsulated sclerosing carcinoma	Diffuse Sclerosing Variant Thyroid Gland Papillary Carcinoma
Oat cell carcinoma	Small Cell Neuroendocrine Carcinoma
Odontogenic tumor, malignant	Malignant Odontogenic Neoplasm
Olfactory neuroblastoma	Olfactory Neuroblastoma
Oligoastrocytoma	Oligoastrocytoma
Oligodendroglioma	Oligodendroglioma
Oligodendroglioma, NOS	Oligodendroglioma
Oligodendroglioma, anaplastic	Anaplastic Oligodendroglioma
Optic pathway glioma	Visual Pathway Glioma
Ossifying fibromyxoid tumor	Ossifying Fibromyxoid Tumor
Osteosarcoma in Paget disease of bone	Osteosarcoma Arising in Paget Disease of Bone
Osteosarcoma, NOS	Osteosarcoma
Other, specify	Other
Oxyphilic adenocarcinoma	Oncocytic Adenocarcinoma
Oxyphilic adenoma	Oncocytic Adenoma
Paget disease and infiltrating duct carcinoma of breast	Breast Paget Disease with Invasive Ductal Carcinoma
Paget disease, extramammary	Extramammary Paget Disease
Paget disease, mammary	Breast Paget Disease
Pancreas-Adenocarcinoma Ductal Type	Pancreatic Ductal Adenocarcinoma
Pancreas-Colloid (mucinous non-cystic) Carcinoma	Pancreatic Colloid Carcinoma
Pancreas-Undifferentiated Carcinoma	Pancreatic Undifferentiated Carcinoma
Pancreatic endocrine tumor, NOS	Pancreatic Neuroendocrine Tumor
Pancreatic endocrine tumor, malignant	Pancreatic Neuroendocrine Carcinoma
Pancreatobiliary-type carcinoma	Ampulla of Vater Pancreatobiliary Type Adenocarcinoma
Pancreatoblastoma	Pancreatoblastoma
Papillary RCC	Papillary Renal Cell Carcinoma
Papillary Squamous Cell Carcinoma	Papillary Squamous Cell Carcinoma
Papillary adenocarcinoma, NOS	Papillary Adenocarcinoma
Papillary carcinoma, NOS	Papillary Carcinoma
Papillary carcinoma, columnar cell	Columnar Cell Variant Thyroid Gland Papillary Carcinoma
Papillary carcinoma, follicular variant	Follicular Variant Thyroid Gland Papillary Carcinoma
Papillary glioneuronal tumor	Papillary Glioneuronal Tumor
Papillary meningioma	Papillary Meningioma
Papillary renal cell carcinoma	Papillary Renal Cell Carcinoma
Papillary serous adenocarcinoma	Borderline Ovarian Serous Tumor-Micropapillary Variant/Non-Invasive Low Grade Ovarian Serous Carcinoma
Papillary serous cystadenocarcinoma	Papillary Serous Cystadenocarcinoma
Papillary squamous cell carcinoma	Papillary Squamous Cell Carcinoma
Papillary thyroid carcinoma	Thyroid Gland Papillary Carcinoma
Papillary transitional cell carcinoma	Papillary Transitional Cell Carcinoma
Paraganglioma	Paraganglioma
Paraganglioma, NOS	Paraganglioma
Paraganglioma, malignant	Metastatic Paraganglioma
Paraganglioma; Extra-adrenal Pheochromocytoma	Extra-Adrenal Paraganglioma
Paratesticular rhabdomyosarcoma	Paratesticular Rhabdomyosarcoma
Pheochromocytoma	Adrenal Gland Pheochromocytoma
Pheochromocytoma, NOS	Adrenal Gland Pheochromocytoma
Pheochromocytoma, malignant	Metastatic Adrenal Gland Pheochromocytoma
Phyllodes tumor, borderline	Borderline Phyllodes Tumor
Phyllodes tumor, malignant	Malignant Phyllodes Tumor
Pilocytic Astrocytoma	Pilocytic Astrocytoma
Pilocytic astrocytoma	Pilocytic Astrocytoma
Pilomyxoid astrocytoma	Pilomyxoid Astrocytoma
Pineal parenchymal tumor	Pineal Parenchymal Cell Neoplasm
Pinealoma	Pineal Region Neoplasm
Pineoblastoma	Pineoblastoma
Pituicytoma	Pituicytoma
Pituitary adenoma, NOS	Pituitary Neuroendocrine Tumor
Pituitary carcinoma, NOS	Metastatic Pituitary Neuroendocrine Tumor
Pituitary tumor	Pituitary Gland Neoplasm
Plasma cell myeloma	Multiple Myeloma
Pleomorphic 'MFH' / Undifferentiated pleomorphic sarcoma	Storiform-Pleomorphic Malignant Fibrous Histiocytoma
Pleomorphic carcinoma	Pleomorphic Carcinoma
Pleomorphic liposarcoma	Pleomorphic Liposarcoma
Pleomorphic rhabdomyosarcoma, adult type	Adult Pleomorphic Rhabdomyosarcoma
Pleomorphic xanthoastrocytoma	Pleomorphic Xanthoastrocytoma
Pleuropulmonary blastoma	Pleuropulmonary Blastoma
Polycythemia vera	Polycythemia Vera
Poorly differentiated sarcoma	High Grade Sarcoma
Posterior fossa ependymoma	Posterior Fossa Ependymoma
Posterior fossa group A ependymoma	Posterior Fossa Ependymoma, Group A (PFA)
Posterior fossa tumor	Posterior Fossa Neoplasm
Precursor B-cell lymphoblastic leukemia	B Acute Lymphoblastic Leukemia
Precursor T-cell lymphoblastic leukemia	T Acute Lymphoblastic Leukemia
Precursor cell lymphoblastic leukemia, NOS	Acute Lymphoblastic Leukemia
Precursor cell lymphoblastic lymphoma, NOS	Lymphoblastic Lymphoma
Primary effusion lymphoma	Primary Effusion Lymphoma
Primary myelofibrosis	Primary Myelofibrosis
Primitive neuroectodermal tumor, NOS	Primitive Neuroectodermal Tumor
Prostate Adenocarcinoma Acinar Type	Prostate Acinar Adenocarcinoma
Pseudosarcomatous carcinoma	Sarcomatoid Carcinoma
Pure germinoma	Germinoma
Rectal Adenocarcinoma	Rectal Adenocarcinoma
Rectal Mucinous Adenocarcinoma	Rectal Mucinous Adenocarcinoma
Refractory anemia with excess blasts	Myelodysplastic Syndrome with Excess Blasts
Refractory anemia with sideroblasts	Myelodysplastic Syndrome with Ring Sideroblasts
Refractory cytopenia with multilineage dysplasia	Myelodysplastic Syndrome, Not Otherwise Specified with Multilineage Dysplasia
Renal cell carcinoma, NOS	Renal Cell Carcinoma, Not Otherwise Specified
Renal cell carcinoma, chromophobe type	Chromophobe Renal Cell Carcinoma
Renal cell carcinoma, sarcomatoid	Sarcomatoid Renal Cell Carcinoma
Residual Dermatofibrosarcoma protuberans	Dermatofibrosarcoma Protuberans
Residual high grade astrocytoma with piloid features	High Grade Astrocytoma with Piloid Features
Retinoblastoma, NOS	Retinoblastoma
Retinoblastoma, moderately differentiated	Differentiated Retinoblastoma
Rhabdomyosarcoma	Rhabdomyosarcoma
Rhabdomyosarcoma NOS	Rhabdomyosarcoma
Rhabdomyosarcoma, NOS	Rhabdomyosarcoma
Sarcoma	Sarcoma
Sarcoma, NOS	Sarcoma
Sarcomatoid carcinoma	Sarcomatoid Carcinoma
Schneiderian carcinoma	Schneiderian Carcinoma
Schwannoma	Schwannoma
Sebaceous adenocarcinoma	Head and Neck Sebaceous Carcinoma
Secretory carcinoma of breast	Breast Secretory Carcinoma
Seminoma, NOS	Seminoma
Seromucinous carcinoma	Ovarian Seromucinous Carcinoma
Serous Cystadenocarcinoma	Serous Cystadenocarcinoma
Serous adenocarcinoma, NOS	Serous Cystadenocarcinoma
Serous carcinoma, NOS	Ovarian Serous Adenocarcinoma
Serous cystadenocarcinoma NOS	Serous Cystadenocarcinoma
Serous cystadenocarcinoma, NOS	Serous Cystadenocarcinoma
Serous cystadenoma, NOS	Serous Cystadenoma
Serous cystadenoma, borderline malignancy	Borderline Serous Cystadenoma
Serous endometrial adenocarcinoma	Endometrial Serous Adenocarcinoma
Serous surface papillary carcinoma	Serous Surface Papillary Carcinoma
Serrated adenoma	Traditional Serrated Adenoma
Sertoli Leydig Tumor	Ovarian Sertoli-Leydig Cell Tumor
Sertoli-Leydig cell tumor, poorly differentiated	Poorly Differentiated Ovarian Sertoli-Leydig Cell Tumor
Sex cord tumor, NOS	Sex Cord-Stromal Tumor
Sex cord-gonadal stromal tumor, NOS	Ovarian Sex Cord-Stromal Tumor
Sezary syndrome	Sezary Syndrome
Signet ring cell adenocarcinoma	Signet Ring Cell Carcinoma
Signet ring cell carcinoma	Signet Ring Cell Carcinoma
Skin appendage carcinoma	Adnexal Carcinoma
Small Cell Squamous Cell	Lung Squamous Cell Carcinoma, Small Cell Variant
Small cell neuroendocrine carcinoma	Small Cell Neuroendocrine Carcinoma
Small cell osteosarcoma	Small Cell Osteosarcoma
Small cell sarcoma	Small Cell Sarcoma
Small round blue cell tumor	EWSR1-Negative Small Round Cell Tumor
Smooth muscle tumor of uncertain malignant potential	Smooth Muscle Neoplasm
Solid carcinoma, NOS	Solid Carcinoma
Solitary fibrous tumor	Solitary Fibrous Tumor
Spindle Cell	Spindle Cell Melanoma
Spindle cell melanoma, NOS	Spindle Cell Melanoma
Spindle cell melanoma, type B	Type B Spindle Cell Melanoma
Spindle cell rhabdomyosarcoma	Spindle Cell Rhabdomyosarcoma
Spindle cell sarcoma	Spindle Cell Sarcoma
Squamotransitional cell carcinoma	Vaginal Papillary Carcinoma
Squamous Cell Carcinoma	Squamous Cell Carcinoma
Squamous Cell Carcinoma, Not Otherwise Specified	Squamous Cell Carcinoma
Squamous cell carcinoma NOS	Squamous Cell Carcinoma
Squamous cell carcinoma, NOS	Squamous Cell Carcinoma
Squamous cell carcinoma, keratinizing, NOS	Keratinizing Squamous Cell Carcinoma
Squamous cell carcinoma, large cell, nonkeratinizing, NOS	Non-Keratinizing Large Cell Squamous Cell Carcinoma
Squamous cell carcinoma, small cell, nonkeratinizing	Non-Keratinizing Small Cell Squamous Cell Carcinoma
Squamous cell carcinoma, spindle cell	Spindle Cell Squamous Cell Carcinoma
Stomach Adenocarcinoma, Signet Ring Type	Gastric Signet Ring Cell Adenocarcinoma
Stomach, Adenocarcinoma, Diffuse Type	Gastric Diffuse Adenocarcinoma
Stomach, Adenocarcinoma, Not Otherwise Specified (NOS)	Gastric Adenocarcinoma
Stomach, Intestinal Adenocarcinoma, Mucinous Type	Gastric Intestinal-Type Adenocarcinoma
Stomach, Intestinal Adenocarcinoma, Not Otherwise Specified (NOS)	Gastric Intestinal-Type Adenocarcinoma
Stomach, Intestinal Adenocarcinoma, Papillary Type	Sinonasal Adenocarcinoma, Intestinal-Type with Papillary Pattern
Stomach, Intestinal Adenocarcinoma, Tubular Type	Gastric Tubular Adenocarcinoma
Subependymal giant cell astrocytoma	Subependymal Giant Cell Astrocytoma
Subependymoma	Subependymoma
Superficial spreading melanoma	Low-CSD Melanoma
Supratentorial ependymoma	Supratentorial Ependymoma
Synovial Sarcoma - Biphasic	Biphasic Synovial Sarcoma
Synovial Sarcoma - Monophasic	Monophasic Synovial Sarcoma
Synovial sarcoma	Synovial Sarcoma
Synovial sarcoma, NOS	Synovial Sarcoma
Synovial sarcoma, biphasic	Biphasic Synovial Sarcoma
Synovial sarcoma, monophasic-type	Monophasic Synovial Sarcoma
Synovial sarcoma, spindle cell	Spindle Cell Synovial Sarcoma
T lymphoblastic leukemia/lymphoma	T Lymphoblastic Leukemia/Lymphoma
T-cell large granular lymphocytic leukemia	T-Cell Large Granular Lymphocyte Leukemia
Tenosynovial giant cell tumor	Tenosynovial Giant Cell Tumor
Teratocarcinoma	Mixed Embryonal Carcinoma and Teratoma
Teratoma with malignant transformation	Teratoma with Somatic-Type Malignancy
Teratoma, NOS	Teratoma
Teratoma, benign	Teratoma
Teratoma, malignant, NOS	Malignant Teratoma
Thecoma, NOS	Thecoma
Therapy related myeloid neoplasm	Therapy-Related Myeloid Neoplasm
Therapy-related acute myeloid leukemia, NOS	Therapy-Related Acute Myeloid Leukemia
Therapy-related myelodysplastic syndrome, NOS	Therapy-Related Myelodysplastic Syndrome
Thymic carcinoma, NOS	Thymic Carcinoma, Not Otherwise Specified
Thymoma, NOS	Thymoma
Thymoma, type A, NOS	Thymoma Type A
Thymoma, type A, malignant	Malignant Type A Thymoma
Thymoma, type AB, NOS	Thymoma Type AB
Thymoma, type AB, malignant	Malignant Type AB Thymoma
Thymoma, type B1, NOS	Thymoma Type B1
Thymoma, type B1, malignant	Malignant Type B1 Thymoma
Thymoma, type B2, NOS	Thymoma Type B2
Thymoma, type B2, malignant	Malignant Type B2 Thymoma
Thymoma, type B3, malignant	Thymoma Type B3
Thymoma; Type A	Thymoma Type A
Thymoma; Type AB	Thymoma Type AB
Thymoma; Type B1	Thymoma Type B1
Thymoma; Type B2	Thymoma Type B2
Thymoma; Type B3	Thymoma Type B3
Thymoma; Type C	Thymic Carcinoma
Thyroid Papillary Carcinoma - Follicular (>= 99% follicular patterned)	Invasive Follicular Variant Thyroid Gland Papillary Carcinoma
Thyroid Papillary Carcinoma - Tall Cell (>= 50% tall cell features)	Tall Cell Variant Thyroid Gland Papillary Carcinoma
Transitional cell carcinoma	Transitional Cell Carcinoma
Trophoblastic tumor, epithelioid	Epithelioid Trophoblastic Tumor
Tubular adenocarcinoma	Tubular Adenocarcinoma
Tubulovillous adenoma, NOS	Tubulovillous Adenoma
Tumor, NOS	Neoplasm
Undifferentiated Pleomorphic Sarcoma (UPS)	Undifferentiated Pleomorphic Sarcoma
Undifferentiated sarcoma	Undifferentiated Soft Tissue Sarcoma
Urothelial carcinoma, NOS	Urothelial Carcinoma
Uterine Carcinosarcoma/ MMMT: Heterologous Type	Uterine Carcinosarcoma, Heterologous Type
Uterine Carcinosarcoma/ Malignant Mixed Mullerian Tumor (MMMT): NOS	Uterine Carcinosarcoma
Uveal Melanoma; Epithelioid Cell	Uveal Epithelioid Cell Melanoma
Uveal Melanoma; Spindle Cell	Uveal Spindle Cell Melanoma
Villous adenocarcinoma	Villous Adenocarcinoma
Waldenstrom macroglobulinemia	Waldenstrom Macroglobulinemia
Warty carcinoma	Warty Carcinoma
Wilms tumor	Wilms Tumor
Yolk sac tumor	Yolk Sac Tumor
low grade glioma consistent with pilocytic astrocytoma	Pilocytic Astrocytoma
